F;E;E;E;E;E;E;E;E;E;E;E;E;E;E;F
F;E;E;E;E;E;E;E;E;E;E;E;E;E;E;F
F;G;E;E;E;E;E;E;E;E;E;E;E;E;G;F
F;F;F;E;E;E;E;E;E;E;E;E;E;F;F;F
F;E;E;E;E;E;E;P;E;E;E;E;E;E;E;F
F;E;F;F;F;F;F;F;F;F;F;F;F;F;E;F
F;E;E;P;E;E;E;E;E;E;E;E;P;E;E;F
F;F;F;F;F;F;E;E;E;E;F;F;F;F;F;F
F;E;E;E;E;E;E;E;E;E;E;E;E;E;E;F
F;E;E;E;E;F;F;F;F;F;F;E;E;E;E;F
F;E;E;T;E;E;E;E;E;E;E;E;N;E;E;F
F;F;F;F;F;F;F;F;F;F;F;F;F;F;F;F
