F;E;E;C;E;E;E;G;G;E;E;E;C;E;E;F
F;E;E;F;F;F;F;F;F;F;F;F;F;E;E;F
F;E;E;E;E;E;E;E;E;E;E;E;E;E;E;F
F;E;F;F;F;F;F;E;E;F;F;F;F;F;E;F
F;E;E;E;E;G;F;E;E;F;G;E;E;E;E;F
F;E;F;F;F;F;F;E;E;F;F;F;F;F;E;F
F;E;C;E;E;E;E;E;E;E;E;E;E;C;E;F
F;E;F;F;F;F;F;E;E;F;F;F;F;F;E;F
F;E;F;E;E;P;E;E;E;E;P;E;E;F;E;F
F;E;F;F;F;F;F;E;E;F;F;F;F;F;E;F
F;E;E;T;E;E;E;E;E;E;E;E;N;E;E;F
F;F;F;F;F;F;F;F;F;F;F;F;F;F;F;F
