F;E;E;E;E;E;E;E;E;E;G;E;G;E;E;F
F;E;E;E;E;F;F;F;F;F;F;F;F;F;E;F
F;E;E;E;E;E;C;E;C;E;E;E;E;F;E;F
F;E;F;F;F;F;F;F;F;F;F;E;E;F;E;F
F;E;F;E;E;E;E;E;E;E;E;E;E;F;E;F
F;E;F;F;E;E;F;F;F;F;F;F;F;F;E;F
F;C;E;E;E;E;E;E;E;E;E;E;E;E;C;F
F;F;F;F;F;F;F;E;E;F;F;F;F;F;F;F
F;F;F;E;E;P;E;E;E;E;P;E;E;F;F;F
F;F;F;F;F;F;F;E;E;F;F;F;F;F;F;F
F;E;E;T;E;E;E;E;E;E;E;E;N;E;E;F
F;F;F;F;F;F;F;F;F;F;F;F;F;F;F;F
