F,E,E,E,E,E,E,E,E,E,E,E,E,E,E,F,10
F,E,E,E,E,E,E,P,E,E,E,E,E,E,E,F,10
F,E,E,F,F,F,F,F,F,F,F,F,F,E,E,F,10
F,P,E,E,E,E,E,E,E,E,E,E,E,E,P,F,10
F,F,F,F,F,E,E,E,E,E,E,F,F,F,F,F,10
F,E,E,E,E,E,E,P,E,E,E,E,E,E,E,F,10
F,E,E,F,F,F,F,F,F,F,F,F,F,E,E,F,10
F,E,E,E,E,E,E,E,E,E,E,E,E,E,E,F,10
F,F,F,F,F,E,E,E,E,E,E,F,F,F,F,F,10
F,E,E,E,E,P,E,E,E,E,P,E,E,E,E,F,10
F,E,E,F,F,F,F,F,F,F,F,F,F,E,E,F,10
F,E,E,T,E,E,E,E,E,E,E,E,N,E,E,F,10
F,F,F,F,F,F,F,F,F,F,F,F,F,F,F,F,10
