F,E,E,E,E,E,E,E,E,E,E,E,E,E,E,F,10
F,E,E,E,E,E,E,C,E,E,E,E,E,E,E,F,10
F,E,E,F,F,F,F,F,F,F,F,F,F,E,E,F,10
F,E,E,E,E,E,E,F,F,E,E,E,E,E,E,F,10
F,F,F,F,E,E,F,F,F,F,E,E,F,F,F,F,10
F,E,E,E,G,E,F,F,F,F,E,G,E,E,E,F,10
F,E,F,F,F,F,F,F,F,F,F,F,F,F,E,F,10
F,E,P,E,E,E,F,F,F,F,E,E,E,P,E,F,10
F,F,F,F,E,E,F,F,F,F,E,E,F,F,F,F,10
F,E,E,E,P,E,E,F,F,E,E,P,E,E,E,F,10
F,E,E,F,F,F,F,F,F,F,F,F,F,E,E,F,10
F,E,E,T,E,E,E,E,E,E,E,E,N,E,E,F,10
F,F,F,F,F,F,F,F,F,F,F,F,F,F,F,F,10
