F,E,E,E,E,E,E,E,E,E,E,E,E,E,E,F,10
F,E,E,C,E,E,E,G,G,E,E,E,G,E,E,F,10
F,E,E,F,F,F,F,F,F,F,F,F,F,E,E,F,10
F,E,E,E,E,E,E,E,E,E,E,E,E,E,E,F,10
F,E,F,F,F,F,F,E,E,F,F,F,F,E,E,F,10
F,E,E,E,E,G,F,E,E,F,G,E,E,E,E,F,10
F,E,F,F,F,F,F,E,E,F,F,F,F,E,E,F,10
F,E,C,E,E,E,E,E,E,E,E,E,E,C,E,F,10
F,E,F,F,F,F,F,E,E,F,F,F,F,E,E,F,10
F,E,F,E,E,P,E,E,E,E,P,E,E,F,E,F,10
F,E,F,F,F,F,F,E,E,F,F,F,F,E,E,F,10
F,E,E,T,E,E,E,E,E,E,E,E,N,E,E,F,10
F,F,F,F,F,F,F,F,F,F,F,F,F,F,F,F,10
