F;E;E;E;E;E;E;E;E;E;E;E;E;E;E;F
F;E;E;E;E;E;E;E;E;E;E;E;E;E;E;F
F;E;E;E;E;E;E;E;E;E;E;E;E;E;E;F
F;E;E;E;E;E;E;E;E;E;E;E;E;E;E;F
F;E;E;E;E;E;E;C;E;E;E;E;E;E;E;F
F;E;E;F;F;F;F;F;F;F;F;F;F;E;E;F
F;E;E;G;E;E;E;E;E;E;E;E;P;E;E;F
F;F;F;F;F;E;E;E;E;E;E;F;F;F;F;F
F;E;E;E;E;E;E;E;E;E;E;E;E;E;E;F
F;E;E;F;F;F;F;F;F;F;F;F;F;E;E;F
F;E;T;E;E;E;E;E;E;E;E;E;N;E;E;F
F;F;F;F;F;F;F;F;F;F;F;F;F;F;F;F
