F;E;E;E;G;E;E;G;E;E;E;E;E;E;E;F
F;E;E;F;F;F;F;F;F;F;F;E;F;E;E;F
F;E;E;E;E;E;E;E;P;E;P;E;F;E;E;F
F;E;E;F;E;F;F;F;F;F;F;F;F;E;E;F
F;E;E;F;E;P;E;P;E;E;E;E;E;E;E;F
F;E;E;F;F;F;F;F;F;F;F;E;F;E;E;F
F;E;E;E;E;E;E;E;E;E;P;E;F;E;E;F
F;E;E;F;E;F;F;F;F;F;F;F;F;E;E;F
F;E;E;F;E;E;E;E;E;E;E;E;E;E;E;F
F;E;E;F;F;F;F;F;F;F;F;F;F;E;E;F
F;E;E;T;E;E;E;E;E;E;E;E;N;E;E;F
F;F;F;F;F;F;F;F;F;F;F;F;F;F;F;F
