F,E,E,E,E,E,E,E,E,E,E,E,E,E,E,F,10
F,E,E,E,E,E,E,E,E,E,G,E,G,E,E,F,10
F,E,E,E,E,F,F,F,F,F,F,F,F,F,E,F,10
F,E,E,E,E,E,C,E,C,E,E,E,E,F,E,F,10
F,E,F,F,F,F,F,F,F,F,F,E,E,F,E,F,10
F,E,F,E,E,E,E,E,E,E,E,E,E,F,E,F,10
F,E,F,F,E,E,F,F,F,F,F,F,F,F,E,F,10
F,C,E,E,E,E,E,E,E,E,E,E,E,E,C,F,10
F,F,F,F,F,F,F,E,E,F,F,F,F,F,F,F,10
F,F,F,E,E,P,E,E,E,E,P,E,E,F,F,F,10
F,F,F,F,F,F,F,E,E,F,F,F,F,F,F,F,10
F,E,E,T,E,E,E,E,E,E,E,E,N,E,E,F,10
F,F,F,F,F,F,F,F,F,F,F,F,F,F,F,F,10
